cycle, observation, reward, action, explored, explore_rate, total reward, average reward
1, 32649, 0, 3, 0, 0, 0, 0
2, 29962, 1011, 2, 0, 0, 1011, 505.5
3, 30472, 991, 1, 0, 0, 2002, 667.333
4, 29189, 991, 0, 0, 0, 2993, 748.25
5, 29189, 1011, 2, 0, 0, 4004, 800.8
6, 29189, 1011, 0, 0, 0, 5015, 835.833
7, 29189, 1011, 1, 0, 0, 6026, 860.857
8, 29954, 991, 1, 0, 0, 7017, 877.125
9, 29954, 1011, 0, 0, 0, 8028, 892
10, 29962, 991, 0, 0, 0, 9019, 901.9
11, 32002, 991, 2, 0, 0, 10010, 910
12, 29962, 1001, 0, 0, 0, 11011, 917.583
13, 32002, 1001, 1, 0, 0, 12012, 924
14, 32002, 1011, 3, 0, 0, 13023, 930.214
15, 30725, 991, 3, 0, 0, 14014, 934.267
16, 29960, 941, 3, 0, 0, 14955, 934.688
17, 29962, 1011, 0, 0, 0, 15966, 939.176
18, 30472, 991, 2, 0, 0, 16957, 942.056
19, 29962, 1001, 2, 0, 0, 17958, 945.158
20, 30472, 991, 3, 0, 0, 18949, 947.45
21, 30472, 1011, 2, 0, 0, 19960, 950.476
22, 29962, 991, 3, 0, 0, 20951, 952.318
23, 29962, 1011, 0, 0, 0, 21962, 954.87
24, 30472, 1001, 0, 0, 0, 22963, 956.792
25, 29962, 1001, 2, 0, 0, 23964, 958.56
26, 30472, 1001, 1, 0, 0, 24965, 960.192
27, 29189, 991, 2, 0, 0, 25956, 961.333
28, 29189, 1011, 3, 0, 0, 26967, 963.107
29, 30472, 1001, 2, 0, 0, 27968, 964.414
30, 29962, 1001, 2, 0, 0, 28969, 965.633
31, 32130, 991, 1, 0, 0, 29960, 966.452
32, 32130, 1011, 3, 0, 0, 30971, 967.844
33, 30853, 991, 1, 0, 0, 31962, 968.545
34, 32130, 1001, 1, 0, 0, 32963, 969.5
35, 32130, 1011, 0, 0, 0, 33974, 970.686
36, 30026, 1001, 0, 0, 0, 34975, 971.528
37, 30536, 1001, 1, 0, 0, 35976, 972.324
38, 29317, 1001, 3, 0, 0, 36977, 973.079
39, 30504, 951, 3, 0, 0, 37928, 972.513
40, 29962, 1011, 1, 0, 0, 38939, 973.475
41, 29962, 1011, 1, 0, 0, 39950, 974.39
42, 29962, 1011, 0, 0, 0, 40961, 975.262
43, 30472, 991, 0, 0, 0, 41952, 975.628
44, 29962, 991, 1, 0, 0, 42943, 975.977
45, 29962, 1011, 2, 0, 0, 43954, 976.756
46, 30472, 1001, 3, 0, 0, 44955, 977.283
47, 30472, 1011, 2, 0, 0, 45966, 978
48, 29962, 1001, 3, 0, 0, 46967, 978.479
49, 29962, 1011, 0, 0, 0, 47978, 979.143
50, 30472, 1001, 3, 0, 0, 48979, 979.58
51, 30472, 1011, 2, 0, 0, 49990, 980.196
52, 29962, 1001, 1, 0, 0, 50991, 980.596
53, 29962, 1011, 2, 0, 0, 52002, 981.17
54, 30472, 991, 2, 0, 0, 52993, 981.352
55, 29962, 991, 3, 0, 0, 53984, 981.527
56, 29962, 1011, 3, 0, 0, 54995, 982.054
57, 29962, 1011, 3, 0, 0, 56006, 982.561
58, 29962, 1011, 2, 0, 0, 57017, 983.052
59, 32002, 991, 1, 0, 0, 58008, 983.186
60, 32002, 1011, 0, 0, 0, 59019, 983.65
61, 29962, 1001, 1, 0, 0, 60020, 983.934
62, 29962, 1011, 0, 0, 0, 61031, 984.371
63, 30472, 1001, 3, 0, 0, 62032, 984.635
64, 30472, 1011, 3, 0, 0, 63043, 985.047
65, 30472, 1011, 3, 0, 0, 64054, 985.446
66, 30472, 1011, 2, 0, 0, 65065, 985.833
67, 29962, 1001, 1, 0, 0, 66066, 986.06
68, 29962, 1011, 1, 0, 0, 67077, 986.426
69, 29962, 1011, 3, 0, 0, 68088, 986.783
70, 29962, 1011, 2, 0, 0, 69099, 987.129
71, 32002, 1001, 3, 0, 0, 70100, 987.324
72, 30725, 991, 3, 0, 0, 71091, 987.375
73, 30980, 991, 2, 0, 0, 72082, 987.425
74, 30980, 1011, 2, 0, 0, 73093, 987.743
75, 31108, 1011, 0, 0, 0, 74104, 988.053
76, 28938, 991, 1, 0, 0, 75095, 988.092
77, 28938, 1011, 1, 0, 0, 76106, 988.39
78, 28938, 1011, 2, 0, 0, 77117, 988.679
79, 30980, 951, 0, 0, 0, 78068, 988.203
80, 30472, 991, 0, 0, 0, 79059, 988.237
81, 29962, 991, 1, 0, 0, 80050, 988.272
82, 29962, 1011, 1, 0, 0, 81061, 988.549
83, 29962, 1011, 2, 0, 0, 82072, 988.819
84, 30472, 1001, 2, 0, 0, 83073, 988.964
85, 29962, 1001, 1, 0, 0, 84074, 989.106
86, 29962, 1011, 2, 0, 0, 85085, 989.36
87, 30472, 991, 2, 0, 0, 86076, 989.379
88, 29962, 991, 3, 0, 0, 87067, 989.398
89, 29962, 1011, 0, 0, 0, 88078, 989.64
90, 30472, 1001, 0, 0, 0, 89079, 989.767
91, 29962, 1001, 3, 0, 0, 90080, 989.89
92, 29962, 1011, 0, 0, 0, 91091, 990.12
93, 30472, 1001, 1, 0, 0, 92092, 990.237
94, 29189, 991, 1, 0, 0, 93083, 990.245
95, 29954, 991, 3, 0, 0, 94074, 990.253
96, 28677, 1001, 0, 0, 0, 95075, 990.365
97, 28677, 1011, 2, 0, 0, 96086, 990.577
98, 28677, 1011, 3, 0, 0, 97097, 990.786
99, 29960, 1001, 1, 0, 0, 98098, 990.889
100, 28677, 1001, 3, 0, 0, 99099, 990.99
101, 29960, 1001, 0, 0, 0, 100100, 991.089
102, 29962, 1001, 0, 0, 0, 101101, 991.186
103, 32130, 991, 2, 0, 0, 102092, 991.184
104, 29962, 1001, 0, 0, 0, 103093, 991.279
105, 32130, 1001, 2, 0, 0, 104094, 991.371
106, 29962, 1001, 3, 0, 0, 105095, 991.462
107, 29978, 1011, 1, 0, 0, 106106, 991.645
108, 29962, 961, 2, 0, 0, 107067, 991.361
109, 30472, 991, 1, 0, 0, 108058, 991.358
110, 29189, 991, 0, 0, 0, 109049, 991.355
111, 29189, 1011, 1, 0, 0, 110060, 991.532
112, 29954, 991, 3, 0, 0, 111051, 991.527
113, 28677, 1001, 2, 0, 0, 112052, 991.611
114, 28677, 1011, 2, 0, 0, 113063, 991.781
115, 28677, 1011, 3, 0, 0, 114074, 991.948
116, 29960, 1001, 3, 0, 0, 115075, 992.026
117, 29960, 1011, 3, 0, 0, 116086, 992.188
118, 29960, 1011, 2, 0, 0, 117097, 992.347
119, 29962, 991, 1, 0, 0, 118088, 992.336
120, 29962, 1011, 2, 0, 0, 119099, 992.492
121, 32002, 991, 3, 0, 0, 120090, 992.479
122, 30725, 991, 3, 0, 0, 121081, 992.467
123, 30980, 991, 3, 0, 0, 122072, 992.455
124, 30725, 991, 1, 0, 0, 123063, 992.444
125, 30980, 1001, 0, 0, 0, 124064, 992.512
126, 28938, 991, 3, 0, 0, 125055, 992.5
127, 28938, 1011, 0, 0, 0, 126066, 992.646
128, 28938, 991, 0, 0, 0, 127057, 992.633
129, 28938, 991, 2, 0, 0, 128048, 992.62
130, 28938, 1001, 1, 0, 0, 129049, 992.685
131, 28938, 1011, 2, 0, 0, 130060, 992.824
132, 24842, 1001, 1, 0, 0, 131061, 992.886
133, 24842, 1011, 0, 0, 0, 132072, 993.023
134, 28938, 1001, 0, 0, 0, 133073, 993.082
135, 28938, 1001, 1, 0, 0, 134074, 993.141
136, 28938, 1011, 0, 0, 0, 135085, 993.272
137, 28938, 991, 0, 0, 0, 136076, 993.255
138, 28938, 991, 1, 0, 0, 137067, 993.239
139, 28938, 1011, 1, 0, 0, 138078, 993.367
140, 28938, 1011, 2, 0, 0, 139089, 993.493
141, 28938, 1001, 0, 0, 0, 140090, 993.546
142, 28938, 1001, 1, 0, 0, 141091, 993.599
143, 28938, 1011, 1, 0, 0, 142102, 993.72
144, 28938, 1011, 2, 0, 0, 143113, 993.84
145, 28938, 1001, 2, 0, 0, 144114, 993.89
146, 24842, 1001, 0, 0, 0, 145115, 993.938
147, 28938, 1001, 2, 0, 0, 146116, 993.986
148, 24842, 1001, 1, 0, 0, 147117, 994.034
149, 24842, 1011, 2, 0, 0, 148128, 994.148
150, 16650, 1001, 1, 0, 0, 149129, 994.193
151, 16650, 1011, 0, 0, 0, 150140, 994.305
152, 24842, 1001, 2, 0, 0, 151141, 994.349
153, 16650, 1001, 2, 0, 0, 152142, 994.392
154, 24842, 1001, 0, 0, 0, 153143, 994.435
155, 16650, 1001, 1, 0, 0, 154144, 994.477
156, 16650, 1011, 2, 0, 0, 155155, 994.583
157, 24842, 1001, 3, 0, 0, 156156, 994.624
158, 24842, 1011, 3, 0, 0, 157167, 994.728
159, 24842, 1011, 2, 0, 0, 158178, 994.83
160, 30980, 1001, 0, 0, 0, 159179, 994.869
161, 24842, 1001, 1, 0, 0, 160180, 994.907
162, 24842, 1011, 2, 0, 0, 161191, 995.006
163, 30980, 1001, 2, 0, 0, 162192, 995.043
164, 30980, 1011, 3, 0, 0, 163203, 995.14
165, 30725, 1001, 0, 0, 0, 164204, 995.176
166, 30725, 1011, 2, 0, 0, 165215, 995.271
167, 30725, 1011, 0, 0, 0, 166226, 995.365
168, 30725, 1011, 2, 0, 0, 167237, 995.458
169, 30725, 1011, 2, 0, 0, 168248, 995.55
170, 30725, 1011, 3, 0, 0, 169259, 995.641
171, 30725, 991, 1, 0, 0, 170250, 995.614
172, 30725, 1001, 3, 0, 0, 171251, 995.645
173, 30725, 1001, 0, 0, 0, 172252, 995.676
174, 30725, 1011, 0, 0, 0, 173263, 995.764
175, 30725, 1011, 0, 0, 0, 174274, 995.851
176, 30725, 1011, 3, 0, 0, 175285, 995.938
177, 30725, 991, 2, 0, 0, 176276, 995.91
178, 30725, 1011, 2, 0, 0, 177287, 995.994
179, 30725, 1011, 1, 0, 0, 178298, 996.078
180, 30725, 1001, 3, 0, 0, 179299, 996.106
181, 30725, 1001, 3, 0, 0, 180300, 996.133
182, 28940, 991, 2, 0, 0, 181291, 996.104
183, 28956, 1011, 1, 0, 0, 182302, 996.186
184, 28677, 1001, 2, 0, 0, 183303, 996.212
185, 28805, 1011, 0, 0, 0, 184314, 996.292
186, 28677, 911, 2, 0, 0, 185225, 995.833
187, 30472, 991, 1, 0, 0, 186216, 995.807
188, 29189, 991, 1, 0, 0, 187207, 995.782
189, 29954, 991, 3, 0, 0, 188198, 995.757
190, 28677, 1001, 2, 0, 0, 189199, 995.784
191, 28677, 1011, 1, 0, 0, 190210, 995.864
192, 29954, 1001, 2, 0, 0, 191211, 995.891
193, 29962, 991, 0, 0, 0, 192202, 995.865
194, 29954, 1001, 3, 0, 0, 193203, 995.892
195, 28677, 1001, 3, 0, 0, 194204, 995.918
196, 29960, 1001, 1, 0, 0, 195205, 995.944
197, 28677, 1001, 0, 0, 0, 196206, 995.97
198, 28677, 1011, 0, 0, 0, 197217, 996.045
199, 28677, 1011, 3, 0, 0, 198228, 996.121
200, 29960, 1001, 2, 0, 0, 199229, 996.145
201, 29962, 991, 0, 0, 0, 200220, 996.119
202, 29960, 1001, 1, 0, 0, 201221, 996.144
203, 28677, 1001, 2, 0, 0, 202222, 996.167
204, 28677, 1011, 1, 0, 0, 203233, 996.24
205, 29954, 1001, 3, 0, 0, 204234, 996.263
206, 28677, 1001, 1, 0, 0, 205235, 996.286
207, 29954, 1001, 2, 0, 0, 206236, 996.309
208, 29962, 1001, 1, 0, 0, 207237, 996.332
209, 29962, 1011, 3, 0, 0, 208248, 996.402
210, 29962, 1011, 2, 0, 0, 209259, 996.471
211, 30472, 991, 0, 0, 0, 210250, 996.445
212, 29962, 1001, 2, 0, 0, 211251, 996.467
213, 30472, 1001, 2, 0, 0, 212252, 996.488
214, 29962, 991, 3, 0, 0, 213243, 996.463
215, 29962, 1011, 0, 0, 0, 214254, 996.53
216, 30472, 1001, 3, 0, 0, 215255, 996.551
217, 30472, 1011, 1, 0, 0, 216266, 996.618
218, 29189, 991, 3, 0, 0, 217257, 996.592
219, 30472, 1001, 0, 0, 0, 218258, 996.612
220, 29962, 1001, 1, 0, 0, 219259, 996.632
221, 29962, 1011, 2, 0, 0, 220270, 996.697
222, 30472, 1001, 2, 0, 0, 221271, 996.716
223, 29962, 1001, 1, 0, 0, 222272, 996.735
224, 29962, 1011, 1, 0, 0, 223283, 996.799
225, 29962, 1011, 0, 0, 0, 224294, 996.862
226, 30472, 1001, 1, 0, 0, 225295, 996.881
227, 29189, 1001, 2, 0, 0, 226296, 996.899
228, 29189, 1011, 2, 0, 0, 227307, 996.961
229, 29189, 1011, 0, 0, 0, 228318, 997.022
230, 29189, 1011, 1, 0, 0, 229329, 997.083
231, 28934, 991, 3, 0, 0, 230320, 997.056
232, 28677, 1001, 2, 0, 0, 231321, 997.073
233, 28677, 1011, 1, 0, 0, 232332, 997.133
234, 28934, 1001, 1, 0, 0, 233333, 997.15
235, 28934, 1011, 0, 0, 0, 234344, 997.209
236, 28938, 991, 0, 0, 0, 235335, 997.182
237, 29193, 991, 0, 0, 0, 236326, 997.156
238, 29193, 1011, 2, 0, 0, 237337, 997.214
239, 28682, 1001, 3, 0, 0, 238338, 997.23
240, 28682, 1011, 1, 0, 0, 239349, 997.288
241, 28682, 1011, 2, 0, 0, 240360, 997.344
242, 24582, 1001, 2, 0, 0, 241361, 997.36
243, 24582, 1011, 0, 0, 0, 242372, 997.416
244, 28682, 1001, 3, 0, 0, 243373, 997.43
245, 28682, 1011, 2, 0, 0, 244384, 997.486
246, 24582, 1001, 0, 0, 0, 245385, 997.5
247, 28682, 1001, 2, 0, 0, 246386, 997.514
248, 24582, 1001, 2, 0, 0, 247387, 997.528
249, 24582, 1011, 0, 0, 0, 248398, 997.582
250, 28682, 1001, 2, 0, 0, 249399, 997.596
251, 24582, 1001, 0, 0, 0, 250400, 997.61
252, 28682, 1001, 2, 0, 0, 251401, 997.623
253, 24582, 1001, 3, 0, 0, 252402, 997.636
254, 24581, 1001, 3, 0, 0, 253403, 997.65
255, 29960, 1001, 0, 0, 0, 254404, 997.663
256, 29962, 1001, 1, 0, 0, 255405, 997.676
257, 29962, 1011, 3, 0, 0, 256416, 997.728
258, 29962, 1011, 2, 0, 0, 257427, 997.779
259, 29960, 1001, 2, 0, 0, 258428, 997.792
260, 29962, 1001, 2, 0, 0, 259429, 997.804
261, 31492, 991, 0, 0, 0, 260420, 997.778
262, 28938, 1001, 0, 0, 0, 261421, 997.79
263, 24840, 1001, 1, 0, 0, 262422, 997.802
264, 16389, 1001, 2, 0, 0, 263423, 997.814
265, 16389, 1011, 3, 0, 0, 264434, 997.864
266, 24840, 1001, 2, 0, 0, 265435, 997.876
267, 28938, 1001, 0, 0, 0, 266436, 997.888
268, 24840, 1001, 2, 0, 0, 267437, 997.899
269, 28938, 1001, 3, 0, 0, 268438, 997.911
270, 28938, 1011, 1, 0, 0, 269449, 997.959
271, 28938, 1011, 2, 0, 0, 270460, 998.007
272, 31492, 1001, 3, 0, 0, 271461, 998.018
273, 31237, 991, 1, 0, 0, 272452, 997.993
274, 31492, 1001, 1, 0, 0, 273453, 998.004
275, 31237, 991, 1, 0, 0, 274444, 997.978
276, 31747, 991, 3, 0, 0, 275435, 997.953
277, 30725, 1001, 2, 0, 0, 276436, 997.964
278, 30725, 1011, 3, 0, 0, 277447, 998.011
279, 30980, 1001, 3, 0, 0, 278448, 998.022
280, 30725, 1001, 0, 0, 0, 279449, 998.032
281, 30725, 1011, 3, 0, 0, 280460, 998.078
282, 32000, 991, 1, 0, 0, 281451, 998.053
283, 30725, 1001, 3, 0, 0, 282452, 998.064
284, 32000, 1001, 1, 0, 0, 283453, 998.074
285, 30725, 1001, 2, 0, 0, 284454, 998.084
286, 30725, 1011, 2, 0, 0, 285465, 998.129
287, 30725, 1011, 2, 0, 0, 286476, 998.174
288, 30725, 1011, 0, 0, 0, 287487, 998.219
289, 30725, 1011, 3, 0, 0, 288498, 998.263
290, 32000, 1001, 1, 0, 0, 289499, 998.272
291, 30725, 1001, 2, 0, 0, 290500, 998.282
292, 30725, 1011, 2, 0, 0, 291511, 998.325
293, 30725, 1011, 1, 0, 0, 292522, 998.369
294, 26884, 1001, 2, 0, 0, 293523, 998.378
295, 26884, 1011, 2, 0, 0, 294534, 998.42
296, 26884, 1011, 3, 0, 0, 295545, 998.463
297, 30725, 1001, 2, 0, 0, 296546, 998.471
298, 30725, 1011, 1, 0, 0, 297557, 998.513
299, 26884, 1001, 1, 0, 0, 298558, 998.522
300, 30725, 1001, 3, 0, 0, 299559, 998.53
301, 26884, 1001, 3, 0, 0, 300560, 998.538
302, 30725, 1001, 2, 0, 0, 301561, 998.546
303, 30725, 1011, 2, 0, 0, 302572, 998.587
304, 30725, 1011, 1, 0, 0, 303583, 998.628
305, 26884, 1001, 3, 0, 0, 304584, 998.636
306, 30725, 1001, 2, 0, 0, 305585, 998.644
307, 30725, 1011, 2, 0, 0, 306596, 998.684
308, 30725, 1011, 2, 0, 0, 307607, 998.724
309, 30725, 1011, 0, 0, 0, 308618, 998.764
310, 30725, 1011, 1, 0, 0, 309629, 998.803
311, 26884, 1001, 0, 0, 0, 310630, 998.81
312, 16650, 1001, 0, 0, 0, 311631, 998.817
313, 24840, 1001, 1, 0, 0, 312632, 998.824
314, 16389, 1001, 0, 0, 0, 313633, 998.831
315, 16389, 1011, 3, 0, 0, 314644, 998.87
316, 24840, 1001, 3, 0, 0, 315645, 998.877
317, 24840, 1011, 1, 0, 0, 316656, 998.915
318, 16389, 1001, 1, 0, 0, 317657, 998.921
319, 24582, 1001, 3, 0, 0, 318658, 998.928
320, 16389, 1001, 3, 0, 0, 319659, 998.934
321, 24840, 1001, 1, 0, 0, 320660, 998.941
322, 16389, 1001, 3, 0, 0, 321661, 998.947
323, 24840, 1001, 1, 0, 0, 322662, 998.954
324, 16389, 1001, 3, 0, 0, 323663, 998.96
325, 24840, 1001, 2, 0, 0, 324664, 998.966
326, 16650, 1001, 1, 0, 0, 325665, 998.972
327, 16650, 1011, 2, 0, 0, 326676, 999.009
328, 26884, 1001, 3, 0, 0, 327677, 999.015
329, 30725, 1001, 2, 0, 0, 328678, 999.021
330, 30725, 1011, 2, 0, 0, 329689, 999.058
331, 30725, 1011, 1, 0, 0, 330700, 999.094
332, 26884, 1001, 3, 0, 0, 331701, 999.099
333, 30725, 1001, 2, 0, 0, 332702, 999.105
334, 30725, 1011, 1, 0, 0, 333713, 999.141
335, 26884, 1001, 1, 0, 0, 334714, 999.146
336, 30725, 1001, 3, 0, 0, 335715, 999.152
337, 26884, 1001, 3, 0, 0, 336716, 999.157
338, 30725, 1001, 3, 0, 0, 337717, 999.163
339, 32016, 1001, 2, 0, 0, 338718, 999.168
340, 29978, 991, 0, 0, 0, 339709, 999.144
341, 32016, 1001, 0, 0, 0, 340710, 999.15
342, 29978, 991, 2, 0, 0, 341701, 999.126
343, 32016, 1001, 1, 0, 0, 342702, 999.131
344, 30725, 1001, 1, 0, 0, 343703, 999.137
345, 26884, 1001, 2, 0, 0, 344704, 999.142
346, 26900, 1011, 3, 0, 0, 345715, 999.176
347, 30725, 1001, 3, 0, 0, 346716, 999.182
348, 32000, 1001, 3, 0, 0, 347717, 999.187
349, 30725, 991, 2, 0, 0, 348708, 999.163
350, 30725, 1011, 2, 0, 0, 349719, 999.197
351, 30725, 1011, 0, 0, 0, 350730, 999.231
352, 30725, 1011, 2, 0, 0, 351741, 999.264
353, 30725, 1011, 2, 0, 0, 352752, 999.297
354, 30725, 1011, 2, 0, 0, 353763, 999.331
355, 30725, 1011, 0, 0, 0, 354774, 999.363
356, 30725, 1011, 3, 0, 0, 355785, 999.396
357, 30725, 991, 1, 0, 0, 356776, 999.373
358, 30725, 1001, 0, 0, 0, 357777, 999.377
359, 30725, 1011, 1, 0, 0, 358788, 999.409
360, 32000, 1001, 0, 0, 0, 359789, 999.414
361, 29962, 1001, 1, 0, 0, 360790, 999.418
362, 29962, 1011, 1, 0, 0, 361801, 999.45
363, 29962, 1011, 3, 0, 0, 362812, 999.482
364, 29962, 1011, 1, 0, 0, 363823, 999.514
365, 29962, 1011, 0, 0, 0, 364834, 999.545
366, 32002, 991, 1, 0, 0, 365825, 999.522
367, 32002, 1011, 0, 0, 0, 366836, 999.553
368, 29962, 1001, 3, 0, 0, 367837, 999.557
369, 29962, 1011, 0, 0, 0, 368848, 999.588
370, 29960, 1001, 3, 0, 0, 369849, 999.592
371, 29960, 1011, 3, 0, 0, 370860, 999.623
372, 29960, 1011, 3, 0, 0, 371871, 999.653
373, 29960, 1011, 1, 0, 0, 372882, 999.684
374, 28677, 1001, 0, 0, 0, 373883, 999.687
375, 28677, 1011, 2, 0, 0, 374894, 999.717
376, 28677, 1011, 0, 0, 0, 375905, 999.747
377, 28677, 1011, 1, 0, 0, 376916, 999.777
378, 28946, 1001, 3, 0, 0, 377917, 999.78
379, 28677, 1001, 0, 0, 0, 378918, 999.784
380, 28709, 1011, 0, 0, 0, 379929, 999.813
381, 28677, 961, 0, 0, 0, 380890, 999.711
382, 30472, 991, 1, 0, 0, 381881, 999.688
383, 29189, 991, 0, 0, 0, 382872, 999.666
384, 29189, 1011, 2, 0, 0, 383883, 999.695
385, 29189, 1011, 1, 0, 0, 384894, 999.725
386, 29954, 991, 3, 0, 0, 385885, 999.702
387, 28677, 1001, 2, 0, 0, 386886, 999.705
388, 28677, 1011, 3, 0, 0, 387897, 999.735
389, 29960, 1001, 3, 0, 0, 388898, 999.738
390, 29960, 1011, 3, 0, 0, 389909, 999.767
391, 29960, 1011, 1, 0, 0, 390920, 999.795
392, 28677, 1001, 2, 0, 0, 391921, 999.798
393, 28677, 1011, 1, 0, 0, 392932, 999.827
394, 29954, 1001, 0, 0, 0, 393933, 999.83
395, 29962, 991, 2, 0, 0, 394924, 999.808
396, 29954, 1001, 0, 0, 0, 395925, 999.811
397, 29962, 1001, 1, 0, 0, 396926, 999.814
398, 29962, 1011, 3, 0, 0, 397937, 999.842
399, 29962, 1011, 0, 0, 0, 398948, 999.87
400, 30472, 991, 0, 0, 0, 399939, 999.847
401, 29962, 991, 2, 0, 0, 400930, 999.825
402, 30472, 1001, 3, 0, 0, 401931, 999.828
403, 30472, 1011, 0, 0, 0, 402942, 999.856
404, 29962, 1001, 1, 0, 0, 403943, 999.859
405, 29962, 1011, 2, 0, 0, 404954, 999.886
406, 30472, 1001, 0, 0, 0, 405955, 999.889
407, 29962, 1001, 3, 0, 0, 406956, 999.892
408, 29962, 1011, 2, 0, 0, 407967, 999.919
409, 30472, 1001, 0, 0, 0, 408968, 999.922
410, 29962, 1001, 0, 0, 0, 409969, 999.924
411, 32257, 991, 3, 0, 0, 410960, 999.903
412, 31237, 991, 0, 0, 0, 411951, 999.881
413, 31237, 1011, 0, 0, 0, 412962, 999.908
414, 31237, 1011, 2, 0, 0, 413973, 999.935
415, 31237, 1011, 2, 0, 0, 414984, 999.961
416, 31365, 1011, 3, 0, 0, 415995, 999.988
417, 32544, 941, 1, 0, 0, 416936, 999.847
418, 29962, 1011, 0, 0, 0, 417947, 999.873
419, 30472, 991, 1, 0, 0, 418938, 999.852
420, 29189, 991, 1, 0, 0, 419929, 999.831
421, 29954, 991, 2, 0, 0, 420920, 999.81
422, 29962, 991, 0, 0, 0, 421911, 999.789
423, 29954, 1001, 2, 0, 0, 422912, 999.792
424, 29962, 1001, 3, 0, 0, 423913, 999.795
425, 29962, 1011, 3, 0, 0, 424924, 999.821
426, 29962, 1011, 3, 0, 0, 425935, 999.847
427, 29962, 1011, 2, 0, 0, 426946, 999.874
428, 32002, 991, 1, 0, 0, 427937, 999.853
429, 32002, 1011, 1, 0, 0, 428948, 999.879
430, 32002, 1011, 2, 0, 0, 429959, 999.905
431, 29962, 991, 3, 0, 0, 430950, 999.884
432, 29962, 1011, 3, 0, 0, 431961, 999.91
433, 29962, 1011, 1, 0, 0, 432972, 999.935
434, 29962, 1011, 1, 0, 0, 433983, 999.961
435, 29962, 1011, 3, 0, 0, 434994, 999.986
436, 29962, 1011, 0, 0, 0, 436005, 1000.01
437, 32002, 1001, 3, 0, 0, 437006, 1000.01
438, 30725, 991, 1, 0, 0, 437997, 999.993
439, 32002, 1001, 3, 0, 0, 438998, 999.995
440, 30725, 1001, 1, 0, 0, 439999, 999.998
441, 32002, 1001, 2, 0, 0, 441000, 1000
442, 29962, 1001, 0, 0, 0, 442001, 1000
443, 32002, 1001, 0, 0, 0, 443002, 1000
444, 29962, 1001, 2, 0, 0, 444003, 1000.01
445, 32002, 1001, 1, 0, 0, 445004, 1000.01
446, 32002, 1011, 1, 0, 0, 446015, 1000.03
447, 32002, 1011, 1, 0, 0, 447026, 1000.06
448, 32002, 1011, 2, 0, 0, 448037, 1000.08
449, 29962, 1001, 3, 0, 0, 449038, 1000.08
450, 29962, 1011, 1, 0, 0, 450049, 1000.11
451, 29962, 1011, 1, 0, 0, 451060, 1000.13
452, 29962, 1011, 3, 0, 0, 452071, 1000.16
453, 29962, 1011, 3, 0, 0, 453082, 1000.18
454, 29962, 1011, 3, 0, 0, 454093, 1000.2
455, 29962, 1011, 1, 0, 0, 455104, 1000.23
456, 29962, 1011, 3, 0, 0, 456115, 1000.25
457, 29962, 1011, 1, 0, 0, 457126, 1000.28
458, 29962, 1011, 2, 0, 0, 458137, 1000.3
459, 30472, 991, 2, 0, 0, 459128, 1000.28
460, 29962, 991, 1, 0, 0, 460119, 1000.26
461, 29962, 1011, 0, 0, 0, 461130, 1000.28
462, 30472, 1001, 3, 0, 0, 462131, 1000.28
463, 30472, 1011, 1, 0, 0, 463142, 1000.31
464, 29189, 991, 0, 0, 0, 464133, 1000.29
465, 29189, 1011, 0, 0, 0, 465144, 1000.31
466, 29189, 1011, 2, 0, 0, 466155, 1000.33
467, 29189, 1011, 0, 0, 0, 467166, 1000.36
468, 29189, 1011, 1, 0, 0, 468177, 1000.38
469, 28934, 991, 0, 0, 0, 469168, 1000.36
470, 28938, 991, 0, 0, 0, 470159, 1000.34
471, 29193, 991, 0, 0, 0, 471150, 1000.32
472, 29193, 1011, 1, 0, 0, 472161, 1000.34
473, 29189, 991, 3, 0, 0, 473152, 1000.32
474, 29193, 1001, 1, 0, 0, 474153, 1000.32
475, 29189, 1001, 2, 0, 0, 475154, 1000.32
476, 29189, 1011, 0, 0, 0, 476165, 1000.35
477, 29189, 1011, 3, 0, 0, 477176, 1000.37
478, 29193, 1001, 0, 0, 0, 478177, 1000.37
479, 29193, 1011, 0, 0, 0, 479188, 1000.39
480, 29193, 1011, 3, 0, 0, 480199, 1000.41
481, 29193, 1011, 0, 0, 0, 481210, 1000.44
482, 29193, 1011, 1, 0, 0, 482221, 1000.46
483, 29189, 1001, 2, 0, 0, 483222, 1000.46
484, 29189, 1011, 0, 0, 0, 484233, 1000.48
485, 29189, 1011, 1, 0, 0, 485244, 1000.5
486, 29954, 991, 2, 0, 0, 486235, 1000.48
487, 29962, 991, 1, 0, 0, 487226, 1000.46
488, 29962, 1011, 0, 0, 0, 488237, 1000.49
489, 29954, 1001, 2, 0, 0, 489238, 1000.49
490, 29962, 1001, 3, 0, 0, 490239, 1000.49
491, 29962, 1011, 2, 0, 0, 491250, 1000.51
492, 29962, 991, 2, 0, 0, 492241, 1000.49
493, 29962, 991, 2, 0, 0, 493232, 1000.47
494, 29962, 991, 1, 0, 0, 494223, 1000.45
495, 29962, 1011, 0, 0, 0, 495234, 1000.47
496, 29962, 1001, 2, 0, 0, 496235, 1000.47
497, 29962, 1001, 3, 0, 0, 497236, 1000.47
498, 29962, 1011, 0, 0, 0, 498247, 1000.5
499, 29962, 1001, 2, 0, 0, 499248, 1000.5
500, 29962, 1001, 1, 0, 0, 500249, 1000.5
501, 29962, 1011, 1, 0, 0, 501260, 1000.52
502, 29962, 1011, 1, 0, 0, 502271, 1000.54
503, 29962, 1011, 1, 0, 0, 503282, 1000.56
504, 29962, 1011, 0, 0, 0, 504293, 1000.58
505, 29962, 1001, 2, 0, 0, 505294, 1000.58
506, 29962, 1001, 3, 0, 0, 506295, 1000.58
507, 29962, 1011, 0, 0, 0, 507306, 1000.6
508, 29962, 1001, 2, 0, 0, 508307, 1000.6
509, 29962, 1001, 3, 0, 0, 509308, 1000.61
510, 29962, 1011, 2, 0, 0, 510319, 1000.63
511, 29962, 991, 2, 0, 0, 511310, 1000.61
512, 29962, 991, 2, 0, 0, 512301, 1000.59
513, 30982, 991, 1, 0, 0, 513292, 1000.57
514, 30982, 1011, 0, 0, 0, 514303, 1000.59
515, 28938, 1001, 1, 0, 0, 515304, 1000.59
516, 28938, 1011, 2, 0, 0, 516315, 1000.61
517, 30982, 1001, 2, 0, 0, 517316, 1000.61
518, 30982, 1011, 1, 0, 0, 518327, 1000.63
519, 31110, 1011, 1, 0, 0, 519338, 1000.65
520, 31110, 1011, 0, 0, 0, 520349, 1000.67
521, 29002, 1001, 3, 0, 0, 521350, 1000.67
522, 28938, 961, 3, 0, 0, 522311, 1000.6
523, 29962, 1011, 2, 0, 0, 523322, 1000.62
524, 30472, 991, 3, 0, 0, 524313, 1000.6
525, 30472, 1011, 2, 0, 0, 525324, 1000.62
526, 29962, 991, 1, 0, 0, 526315, 1000.6
527, 29962, 1011, 3, 0, 0, 527326, 1000.62
528, 29962, 1011, 3, 0, 0, 528337, 1000.64
529, 29962, 1011, 3, 0, 0, 529348, 1000.66
530, 29962, 1011, 3, 0, 0, 530359, 1000.68
531, 29962, 1011, 3, 0, 0, 531370, 1000.7
532, 29962, 1011, 0, 0, 0, 532381, 1000.72
533, 30472, 1001, 3, 0, 0, 533382, 1000.72
534, 30472, 1011, 1, 0, 0, 534393, 1000.74
535, 29189, 991, 1, 0, 0, 535384, 1000.72
536, 29954, 991, 1, 0, 0, 536375, 1000.7
537, 29954, 1011, 0, 0, 0, 537386, 1000.72
538, 29962, 991, 1, 0, 0, 538377, 1000.7
539, 29962, 1011, 2, 0, 0, 539388, 1000.72
540, 29954, 1001, 1, 0, 0, 540389, 1000.72
541, 29954, 1011, 0, 0, 0, 541400, 1000.74
542, 29962, 1001, 0, 0, 0, 542401, 1000.74
543, 32002, 991, 3, 0, 0, 543392, 1000.72
544, 30725, 991, 0, 0, 0, 544383, 1000.7
545, 30725, 1011, 2, 0, 0, 545394, 1000.72
546, 30725, 1011, 2, 0, 0, 546405, 1000.74
547, 30725, 1011, 3, 0, 0, 547416, 1000.76
548, 29960, 991, 0, 0, 0, 548407, 1000.74
549, 29962, 991, 2, 0, 0, 549398, 1000.72
550, 29960, 1001, 0, 0, 0, 550399, 1000.73
551, 29962, 1001, 2, 0, 0, 551400, 1000.73
552, 29960, 1001, 0, 0, 0, 552401, 1000.73
553, 29962, 1001, 0, 0, 0, 553402, 1000.73
554, 32002, 991, 1, 0, 0, 554393, 1000.71
555, 32002, 1011, 3, 0, 0, 555404, 1000.73
556, 30725, 991, 0, 0, 0, 556395, 1000.71
557, 30725, 1011, 0, 0, 0, 557406, 1000.73
558, 30725, 1011, 3, 0, 0, 558417, 1000.75
559, 31745, 991, 2, 0, 0, 559408, 1000.73
560, 29706, 991, 3, 0, 0, 560399, 1000.71
561, 29706, 1011, 3, 0, 0, 561410, 1000.73
562, 29706, 1011, 1, 0, 0, 562421, 1000.75
563, 29706, 1011, 1, 0, 0, 563432, 1000.77
564, 29706, 1011, 1, 0, 0, 564443, 1000.79
565, 29706, 1011, 2, 0, 0, 565454, 1000.8
566, 29706, 991, 0, 0, 0, 566445, 1000.79
567, 29706, 1001, 2, 0, 0, 567446, 1000.79
568, 29706, 1001, 1, 0, 0, 568447, 1000.79
569, 29706, 1011, 2, 0, 0, 569458, 1000.8
570, 29706, 991, 1, 0, 0, 570449, 1000.79
571, 29706, 1011, 1, 0, 0, 571460, 1000.81
572, 29706, 1011, 1, 0, 0, 572471, 1000.82
573, 29706, 1011, 2, 0, 0, 573482, 1000.84
574, 29706, 991, 2, 0, 0, 574473, 1000.82
575, 29706, 991, 3, 0, 0, 575464, 1000.81
576, 29706, 1011, 2, 0, 0, 576475, 1000.82
577, 31236, 991, 0, 0, 0, 577466, 1000.81
578, 28682, 1001, 3, 0, 0, 578467, 1000.81
579, 28682, 1011, 1, 0, 0, 579478, 1000.83
580, 28682, 1011, 2, 0, 0, 580489, 1000.84
581, 31236, 1001, 3, 0, 0, 581490, 1000.84
582, 31237, 991, 1, 0, 0, 582481, 1000.83
583, 31236, 1001, 3, 0, 0, 583482, 1000.83
584, 31237, 1001, 0, 0, 0, 584483, 1000.83
585, 31237, 1011, 1, 0, 0, 585494, 1000.84
586, 31236, 1001, 0, 0, 0, 586495, 1000.84
587, 28682, 1001, 1, 0, 0, 587496, 1000.84
588, 28682, 1011, 3, 0, 0, 588507, 1000.86
589, 28682, 1011, 2, 0, 0, 589518, 1000.88
590, 31236, 1001, 2, 0, 0, 590519, 1000.88
591, 31236, 1011, 3, 0, 0, 591530, 1000.9
592, 31237, 1001, 3, 0, 0, 592531, 1000.9
593, 31237, 991, 1, 0, 0, 593522, 1000.88
594, 31237, 1001, 0, 0, 0, 594523, 1000.88
595, 31237, 1011, 3, 0, 0, 595534, 1000.9
596, 31237, 1001, 2, 0, 0, 596535, 1000.9
597, 31237, 1011, 3, 0, 0, 597546, 1000.91
598, 31237, 991, 0, 0, 0, 598537, 1000.9
599, 31237, 1011, 1, 0, 0, 599548, 1000.91
600, 31237, 1001, 0, 0, 0, 600549, 1000.91
601, 31237, 1011, 0, 0, 0, 601560, 1000.93
602, 31237, 1011, 3, 0, 0, 602571, 1000.95
603, 31237, 1001, 3, 0, 0, 603572, 1000.95
604, 29452, 991, 2, 0, 0, 604563, 1000.93
605, 29468, 1011, 2, 0, 0, 605574, 1000.95
606, 29468, 1011, 2, 0, 0, 606585, 1000.97
607, 29468, 911, 1, 0, 0, 607496, 1000.82
608, 29962, 1011, 3, 0, 0, 608507, 1000.83
609, 29962, 1011, 3, 0, 0, 609518, 1000.85
610, 29962, 1011, 0, 0, 0, 610529, 1000.87
611, 30472, 991, 0, 0, 0, 611520, 1000.85
612, 29962, 991, 0, 0, 0, 612511, 1000.83
613, 32002, 991, 1, 0, 0, 613502, 1000.82
614, 32002, 1011, 0, 0, 0, 614513, 1000.84
615, 29962, 991, 3, 0, 0, 615504, 1000.82
616, 29962, 1011, 1, 0, 0, 616515, 1000.84
617, 29962, 1011, 0, 0, 0, 617526, 1000.85
618, 32512, 991, 2, 0, 0, 618517, 1000.84
619, 29962, 1001, 0, 0, 0, 619518, 1000.84
620, 32512, 1001, 3, 0, 0, 620519, 1000.84
621, 31237, 991, 1, 0, 0, 621510, 1000.82
622, 32512, 1001, 2, 0, 0, 622511, 1000.82
623, 29962, 1001, 2, 0, 0, 623512, 1000.82
624, 32130, 1001, 3, 0, 0, 624513, 1000.82
625, 30853, 991, 2, 0, 0, 625504, 1000.81
626, 30853, 1011, 1, 0, 0, 626515, 1000.82
627, 32130, 1001, 0, 0, 0, 627516, 1000.82
628, 30026, 1001, 3, 0, 0, 628517, 1000.82
629, 29962, 961, 2, 0, 0, 629478, 1000.76
630, 30472, 991, 2, 0, 0, 630469, 1000.74
631, 29962, 991, 2, 0, 0, 631460, 1000.73
632, 32002, 991, 3, 0, 0, 632451, 1000.71
633, 30725, 991, 1, 0, 0, 633442, 1000.7
634, 32002, 1001, 1, 0, 0, 634443, 1000.7
635, 32002, 1011, 1, 0, 0, 635454, 1000.71
636, 32002, 1011, 1, 0, 0, 636465, 1000.73
637, 32002, 1011, 2, 0, 0, 637476, 1000.75
638, 29962, 991, 0, 0, 0, 638467, 1000.73
639, 32002, 1001, 3, 0, 0, 639468, 1000.73
640, 30853, 1001, 0, 0, 0, 640469, 1000.73
641, 30853, 1011, 3, 0, 0, 641480, 1000.75
642, 31108, 991, 0, 0, 0, 642471, 1000.73
643, 28938, 991, 3, 0, 0, 643462, 1000.72
644, 29002, 1011, 2, 0, 0, 644473, 1000.73
645, 30996, 951, 1, 0, 0, 645424, 1000.66
646, 29962, 1011, 1, 0, 0, 646435, 1000.67
647, 29962, 1011, 2, 0, 0, 647446, 1000.69
648, 30472, 991, 2, 0, 0, 648437, 1000.67
649, 29962, 991, 3, 0, 0, 649428, 1000.66
650, 29962, 1011, 2, 0, 0, 650439, 1000.68
651, 32002, 991, 3, 0, 0, 651430, 1000.66
652, 30725, 991, 0, 0, 0, 652421, 1000.65
653, 30725, 1011, 0, 0, 0, 653432, 1000.66
654, 30725, 1011, 2, 0, 0, 654443, 1000.68
655, 30725, 1011, 3, 0, 0, 655454, 1000.69
656, 30980, 991, 2, 0, 0, 656445, 1000.68
657, 30980, 1011, 1, 0, 0, 657456, 1000.69
658, 30725, 1001, 1, 0, 0, 658457, 1000.69
659, 32002, 1001, 2, 0, 0, 659458, 1000.69
660, 29962, 991, 0, 0, 0, 660449, 1000.68
661, 32002, 1001, 2, 0, 0, 661450, 1000.68
662, 29962, 1001, 1, 0, 0, 662451, 1000.68
663, 29962, 1011, 2, 0, 0, 663462, 1000.7
664, 32512, 991, 1, 0, 0, 664453, 1000.68
665, 31237, 991, 3, 0, 0, 665444, 1000.67
666, 32512, 1001, 2, 0, 0, 666445, 1000.67
667, 29962, 991, 0, 0, 0, 667436, 1000.65
668, 32512, 1001, 1, 0, 0, 668437, 1000.65
669, 31237, 1001, 0, 0, 0, 669438, 1000.65
670, 31237, 1011, 1, 0, 0, 670449, 1000.67
671, 31492, 991, 0, 0, 0, 671440, 1000.66
672, 28938, 991, 0, 0, 0, 672431, 1000.64
673, 29448, 991, 0, 0, 0, 673422, 1000.63
674, 28938, 991, 0, 0, 0, 674413, 1000.61
675, 30978, 991, 3, 0, 0, 675404, 1000.6
676, 28677, 991, 1, 0, 0, 676395, 1000.58
677, 28930, 1001, 2, 0, 0, 677396, 1000.58
678, 28938, 1001, 2, 0, 0, 678397, 1000.59
679, 29448, 1001, 3, 0, 0, 679398, 1000.59
680, 29448, 1011, 3, 0, 0, 680409, 1000.6
681, 29448, 1011, 1, 0, 0, 681420, 1000.62
682, 29189, 991, 0, 0, 0, 682411, 1000.6
683, 29189, 1011, 2, 0, 0, 683422, 1000.62
684, 29189, 1011, 2, 0, 0, 684433, 1000.63
685, 29189, 1011, 1, 0, 0, 685444, 1000.65
686, 28934, 991, 2, 0, 0, 686435, 1000.63
687, 28934, 1011, 1, 0, 0, 687446, 1000.65
688, 28934, 1011, 0, 0, 0, 688457, 1000.66
689, 28938, 991, 3, 0, 0, 689448, 1000.65
690, 28938, 1011, 1, 0, 0, 690459, 1000.67
691, 28938, 1011, 0, 0, 0, 691470, 1000.68
692, 29193, 991, 2, 0, 0, 692461, 1000.67
693, 28682, 1001, 2, 0, 0, 693462, 1000.67
694, 24582, 1001, 3, 0, 0, 694463, 1000.67
695, 16389, 1001, 3, 0, 0, 695464, 1000.67
696, 24840, 1001, 1, 0, 0, 696465, 1000.67
697, 16389, 1001, 0, 0, 0, 697466, 1000.67
698, 16389, 1011, 3, 0, 0, 698477, 1000.68
699, 24840, 1001, 2, 0, 0, 699478, 1000.68
700, 28938, 1001, 0, 0, 0, 700479, 1000.68
701, 24840, 1001, 0, 0, 0, 701480, 1000.68
702, 28938, 1001, 2, 0, 0, 702481, 1000.69
703, 24840, 1001, 1, 0, 0, 703482, 1000.69
704, 16389, 1001, 1, 0, 0, 704483, 1000.69
705, 24582, 1001, 0, 0, 0, 705484, 1000.69
706, 28682, 1001, 2, 0, 0, 706485, 1000.69
707, 24582, 1001, 2, 0, 0, 707486, 1000.69
708, 24582, 1011, 1, 0, 0, 708497, 1000.7
709, 24582, 1011, 0, 0, 0, 709508, 1000.72
710, 28682, 1001, 2, 0, 0, 710509, 1000.72
711, 24582, 1001, 1, 0, 0, 711510, 1000.72
712, 24582, 1011, 2, 0, 0, 712521, 1000.73
713, 24582, 1011, 1, 0, 0, 713532, 1000.75
714, 24582, 1011, 0, 0, 0, 714543, 1000.76
715, 28682, 1001, 2, 0, 0, 715544, 1000.76
716, 24582, 1001, 3, 0, 0, 716545, 1000.76
717, 16389, 1001, 3, 0, 0, 717546, 1000.76
718, 24856, 1001, 3, 0, 0, 718547, 1000.76
719, 24856, 1011, 3, 0, 0, 719558, 1000.78
720, 24840, 961, 3, 0, 0, 720519, 1000.72
721, 29962, 1011, 1, 0, 0, 721530, 1000.74
722, 29962, 1011, 2, 0, 0, 722541, 1000.75
723, 30472, 991, 3, 0, 0, 723532, 1000.74
724, 30472, 1011, 0, 0, 0, 724543, 1000.75
725, 29962, 1001, 3, 0, 0, 725544, 1000.75
726, 29962, 1011, 1, 0, 0, 726555, 1000.76
727, 29962, 1011, 1, 0, 0, 727566, 1000.78
728, 29962, 1011, 0, 0, 0, 728577, 1000.79
729, 30472, 991, 1, 0, 0, 729568, 1000.78
730, 29189, 991, 0, 0, 0, 730559, 1000.77
731, 29189, 1011, 2, 0, 0, 731570, 1000.78
732, 29189, 1011, 1, 0, 0, 732581, 1000.79
733, 29954, 991, 0, 0, 0, 733572, 1000.78
734, 29962, 991, 1, 0, 0, 734563, 1000.77
735, 29962, 1011, 3, 0, 0, 735574, 1000.78
736, 29962, 1011, 3, 0, 0, 736585, 1000.79
737, 29962, 1011, 2, 0, 0, 737596, 1000.81
738, 29954, 1001, 0, 0, 0, 738597, 1000.81
739, 29962, 1001, 3, 0, 0, 739598, 1000.81
740, 29962, 1011, 2, 0, 0, 740609, 1000.82
741, 29954, 1001, 0, 0, 0, 741610, 1000.82
742, 29962, 1001, 0, 0, 0, 742611, 1000.82
743, 30472, 991, 0, 0, 0, 743602, 1000.81
744, 29962, 991, 2, 0, 0, 744593, 1000.8
745, 30472, 1001, 0, 0, 0, 745594, 1000.8
746, 29962, 1001, 2, 0, 0, 746595, 1000.8
747, 30472, 1001, 0, 0, 0, 747596, 1000.8
748, 29962, 1001, 0, 0, 0, 748597, 1000.8
749, 32257, 991, 1, 0, 0, 749588, 1000.79
750, 31237, 991, 1, 0, 0, 750579, 1000.77
751, 30982, 991, 2, 0, 0, 751570, 1000.76
752, 30982, 1011, 3, 0, 0, 752581, 1000.77
753, 30725, 1001, 2, 0, 0, 753582, 1000.77
754, 30725, 1011, 0, 0, 0, 754593, 1000.79
755, 30725, 1011, 0, 0, 0, 755604, 1000.8
756, 30725, 1011, 0, 0, 0, 756615, 1000.81
757, 30725, 1011, 3, 0, 0, 757626, 1000.83
758, 31745, 1001, 2, 0, 0, 758627, 1000.83
759, 29706, 1001, 0, 0, 0, 759628, 1000.83
760, 31745, 1001, 3, 0, 0, 760629, 1000.83
761, 30725, 991, 3, 0, 0, 761620, 1000.81
762, 32000, 991, 0, 0, 0, 762611, 1000.8
763, 29962, 991, 3, 0, 0, 763602, 1000.79
764, 29962, 1011, 1, 0, 0, 764613, 1000.8
765, 29962, 1011, 1, 0, 0, 765624, 1000.82
766, 29962, 1011, 1, 0, 0, 766635, 1000.83
767, 29962, 1011, 0, 0, 0, 767646, 1000.84
768, 29962, 991, 1, 0, 0, 768637, 1000.83
769, 29962, 1011, 1, 0, 0, 769648, 1000.84
770, 29962, 1011, 2, 0, 0, 770659, 1000.86
771, 29962, 1001, 0, 0, 0, 771660, 1000.86
772, 29962, 1001, 0, 0, 0, 772661, 1000.86
773, 30217, 991, 2, 0, 0, 773652, 1000.84
774, 29706, 1001, 2, 0, 0, 774653, 1000.84
775, 29706, 1001, 2, 0, 0, 775654, 1000.84
776, 31744, 1001, 1, 0, 0, 776655, 1000.84
777, 30853, 1001, 2, 0, 0, 777656, 1000.84
778, 30853, 1011, 0, 0, 0, 778667, 1000.86
779, 30853, 1011, 1, 0, 0, 779678, 1000.87
780, 27777, 1001, 2, 0, 0, 780679, 1000.87
781, 29706, 1001, 0, 0, 0, 781680, 1000.87
782, 27649, 1001, 0, 0, 0, 782681, 1000.87
783, 27777, 1011, 2, 0, 0, 783692, 1000.88
784, 29706, 1001, 0, 0, 0, 784693, 1000.88
785, 27777, 1001, 0, 0, 0, 785694, 1000.88
786, 27777, 1011, 1, 0, 0, 786705, 1000.9
787, 30853, 1001, 3, 0, 0, 787706, 1000.9
788, 27649, 1001, 2, 0, 0, 788707, 1000.9
789, 29706, 1001, 2, 0, 0, 789708, 1000.9
790, 30216, 1001, 0, 0, 0, 790709, 1000.9
791, 29706, 1001, 1, 0, 0, 791710, 1000.9
792, 29706, 1011, 0, 0, 0, 792721, 1000.91
793, 27777, 1001, 1, 0, 0, 793722, 1000.91
794, 30725, 1001, 3, 0, 0, 794723, 1000.91
795, 27777, 1001, 0, 0, 0, 795724, 1000.91
796, 27649, 1011, 3, 0, 0, 796735, 1000.92
797, 30725, 1001, 2, 0, 0, 797736, 1000.92
798, 30725, 1011, 3, 0, 0, 798747, 1000.94
799, 31744, 1001, 2, 0, 0, 799748, 1000.94
800, 29706, 991, 2, 0, 0, 800739, 1000.92
801, 31746, 991, 0, 0, 0, 801730, 1000.91
802, 29706, 1001, 2, 0, 0, 802731, 1000.91
803, 31746, 1001, 1, 0, 0, 803732, 1000.91
804, 31746, 1011, 2, 0, 0, 804743, 1000.92
805, 29706, 991, 3, 0, 0, 805734, 1000.91
806, 29706, 1011, 1, 0, 0, 806745, 1000.92
807, 29706, 1011, 3, 0, 0, 807756, 1000.94
808, 29706, 1011, 2, 0, 0, 808767, 1000.95
809, 25608, 1001, 3, 0, 0, 809768, 1000.95
810, 25608, 1011, 0, 0, 0, 810779, 1000.96
811, 29706, 1001, 0, 0, 0, 811780, 1000.96
812, 31746, 1001, 0, 0, 0, 812781, 1000.96
813, 29706, 1001, 0, 0, 0, 813782, 1000.96
814, 31744, 1001, 0, 0, 0, 814783, 1000.96
815, 29706, 1001, 1, 0, 0, 815784, 1000.96
816, 29706, 1011, 3, 0, 0, 816795, 1000.97
817, 29706, 1011, 2, 0, 0, 817806, 1000.99
818, 31744, 1001, 0, 0, 0, 818807, 1000.99
819, 29706, 1001, 2, 0, 0, 819808, 1000.99
820, 31744, 1001, 1, 0, 0, 820809, 1000.99
821, 30725, 1001, 2, 0, 0, 821810, 1000.99
822, 30725, 1011, 3, 0, 0, 822821, 1001
823, 31744, 1001, 2, 0, 0, 823822, 1001
824, 29706, 1001, 3, 0, 0, 824823, 1001
825, 29706, 1011, 2, 0, 0, 825834, 1001.01
826, 31746, 1001, 0, 0, 0, 826835, 1001.01
827, 29706, 1001, 2, 0, 0, 827836, 1001.01
828, 31746, 1001, 1, 0, 0, 828837, 1001.01
829, 31746, 1011, 1, 0, 0, 829848, 1001.02
830, 31746, 1011, 1, 0, 0, 830859, 1001.03
831, 31746, 1011, 2, 0, 0, 831870, 1001.05
832, 29706, 1001, 0, 0, 0, 832871, 1001.05
833, 31746, 1001, 0, 0, 0, 833872, 1001.05
834, 29706, 1001, 1, 0, 0, 834873, 1001.05
835, 29706, 1011, 1, 0, 0, 835884, 1001.06
836, 29706, 1011, 2, 0, 0, 836895, 1001.07
837, 31874, 1001, 2, 0, 0, 837896, 1001.07
838, 29706, 1001, 0, 0, 0, 838897, 1001.07
839, 31874, 1001, 0, 0, 0, 839898, 1001.07
840, 29770, 1001, 0, 0, 0, 840899, 1001.07
841, 31936, 1001, 2, 0, 0, 841900, 1001.07
842, 29722, 951, 1, 0, 0, 842851, 1001.01
843, 29962, 1011, 0, 0, 0, 843862, 1001.02
844, 30472, 991, 2, 0, 0, 844853, 1001.01
845, 29962, 1001, 0, 0, 0, 845854, 1001.01
846, 30472, 1001, 2, 0, 0, 846855, 1001.01
847, 29962, 1001, 1, 0, 0, 847856, 1001.01
848, 29962, 1011, 2, 0, 0, 848867, 1001.02
849, 30472, 991, 3, 0, 0, 849858, 1001.01
850, 30472, 1011, 2, 0, 0, 850869, 1001.02
851, 29962, 991, 1, 0, 0, 851860, 1001.01
852, 29962, 1011, 2, 0, 0, 852871, 1001.02
853, 32002, 991, 0, 0, 0, 853862, 1001.01
854, 29962, 1001, 3, 0, 0, 854863, 1001.01
855, 29962, 1011, 0, 0, 0, 855874, 1001.02
856, 30472, 1001, 2, 0, 0, 856875, 1001.02
857, 29962, 1001, 2, 0, 0, 857876, 1001.02
858, 32002, 1001, 0, 0, 0, 858877, 1001.02
859, 29962, 1001, 1, 0, 0, 859878, 1001.02
860, 29962, 1011, 2, 0, 0, 860889, 1001.03
861, 32002, 1001, 0, 0, 0, 861890, 1001.03
862, 29962, 1001, 1, 0, 0, 862891, 1001.03
863, 29962, 1011, 1, 0, 0, 863902, 1001.05
864, 29962, 1011, 1, 0, 0, 864913, 1001.06
865, 29962, 1011, 0, 0, 0, 865924, 1001.07
866, 30472, 1001, 2, 0, 0, 866925, 1001.07
867, 29962, 1001, 3, 0, 0, 867926, 1001.07
868, 29962, 1011, 0, 0, 0, 868937, 1001.08
869, 30472, 1001, 3, 0, 0, 869938, 1001.08
870, 30472, 1011, 0, 0, 0, 870949, 1001.09
871, 29962, 1001, 2, 0, 0, 871950, 1001.09
872, 30472, 1001, 1, 0, 0, 872951, 1001.09
873, 29189, 991, 0, 0, 0, 873942, 1001.08
874, 29189, 1011, 3, 0, 0, 874953, 1001.09
875, 30472, 1001, 0, 0, 0, 875954, 1001.09
876, 29962, 1001, 0, 0, 0, 876955, 1001.09
877, 30472, 1001, 2, 0, 0, 877956, 1001.09
878, 29962, 1001, 2, 0, 0, 878957, 1001.09
879, 30472, 1001, 3, 0, 0, 879958, 1001.09
880, 30472, 1011, 0, 0, 0, 880969, 1001.1
881, 29962, 1001, 0, 0, 0, 881970, 1001.1
882, 30472, 1001, 3, 0, 0, 882971, 1001.1
883, 30472, 1011, 3, 0, 0, 883982, 1001.11
884, 30472, 1011, 3, 0, 0, 884993, 1001.12
885, 30472, 1011, 1, 0, 0, 886004, 1001.13
886, 29189, 991, 3, 0, 0, 886995, 1001.12
887, 30472, 1001, 0, 0, 0, 887996, 1001.12
888, 29962, 991, 2, 0, 0, 888987, 1001.11
889, 30472, 1001, 0, 0, 0, 889988, 1001.11
890, 29962, 1001, 2, 0, 0, 890989, 1001.11
891, 30488, 1001, 3, 0, 0, 891990, 1001.11
892, 30488, 1011, 3, 0, 0, 893001, 1001.12
893, 30472, 961, 0, 0, 0, 893962, 1001.08
894, 30472, 991, 1, 0, 0, 894953, 1001.07
895, 29189, 991, 3, 0, 0, 895944, 1001.05
896, 30472, 1001, 0, 0, 0, 896945, 1001.05
897, 29962, 991, 1, 0, 0, 897936, 1001.04
898, 29962, 1011, 1, 0, 0, 898947, 1001.05
899, 29962, 1011, 1, 0, 0, 899958, 1001.07
900, 29962, 1011, 0, 0, 0, 900969, 1001.08
901, 32002, 991, 3, 0, 0, 901960, 1001.07
902, 30725, 991, 0, 0, 0, 902951, 1001.05
903, 30725, 1011, 0, 0, 0, 903962, 1001.07
904, 30725, 1011, 1, 0, 0, 904973, 1001.08
905, 32002, 1001, 2, 0, 0, 905974, 1001.08
906, 29962, 1001, 0, 0, 0, 906975, 1001.08
907, 32002, 1001, 1, 0, 0, 907976, 1001.08
908, 32002, 1011, 2, 0, 0, 908987, 1001.09
909, 29962, 1001, 0, 0, 0, 909988, 1001.09
910, 32002, 1001, 0, 0, 0, 910989, 1001.09
911, 29962, 991, 3, 0, 0, 911980, 1001.08
912, 29962, 1011, 2, 0, 0, 912991, 1001.09
913, 32002, 1001, 3, 0, 0, 913992, 1001.09
914, 30725, 1001, 1, 0, 0, 914993, 1001.09
915, 32002, 1001, 2, 0, 0, 915994, 1001.09
916, 25866, 1001, 3, 0, 0, 916995, 1001.09
917, 25866, 1011, 2, 0, 0, 918006, 1001.1
918, 30472, 1001, 2, 0, 0, 919007, 1001.1
919, 29962, 1001, 0, 0, 0, 920008, 1001.1
920, 30472, 1001, 0, 0, 0, 921009, 1001.1
921, 25866, 1001, 3, 0, 0, 922010, 1001.1
922, 25866, 1011, 0, 0, 0, 923021, 1001.11
923, 32130, 1001, 1, 0, 0, 924022, 1001.11
924, 32130, 1011, 2, 0, 0, 925033, 1001.12
925, 25866, 1001, 1, 0, 0, 926034, 1001.12
926, 25866, 1011, 2, 0, 0, 927045, 1001.13
927, 30472, 1001, 0, 0, 0, 928046, 1001.13
928, 25882, 1001, 0, 0, 0, 929047, 1001.13
929, 32066, 951, 2, 0, 0, 929998, 1001.07
930, 30472, 991, 2, 0, 0, 930989, 1001.06
931, 29962, 991, 1, 0, 0, 931980, 1001.05
932, 29962, 1011, 0, 0, 0, 932991, 1001.06
933, 30472, 1001, 0, 0, 0, 933992, 1001.06
934, 29962, 1001, 3, 0, 0, 934993, 1001.06
935, 29962, 1011, 2, 0, 0, 936004, 1001.07
936, 30472, 1001, 2, 0, 0, 937005, 1001.07
937, 29962, 1001, 0, 0, 0, 938006, 1001.07
938, 30472, 1001, 3, 0, 0, 939007, 1001.07
939, 30472, 1011, 2, 0, 0, 940018, 1001.08
940, 29962, 1001, 0, 0, 0, 941019, 1001.08
941, 30472, 1001, 2, 0, 0, 942020, 1001.08
942, 29962, 1001, 2, 0, 0, 943021, 1001.08
943, 32002, 991, 1, 0, 0, 944012, 1001.07
944, 32002, 1011, 2, 0, 0, 945023, 1001.08
945, 29962, 991, 0, 0, 0, 946014, 1001.07
946, 32002, 1001, 1, 0, 0, 947015, 1001.07
947, 32002, 1011, 3, 0, 0, 948026, 1001.08
948, 30725, 991, 0, 0, 0, 949017, 1001.07
949, 30725, 1011, 3, 0, 0, 950028, 1001.08
950, 30980, 991, 2, 0, 0, 951019, 1001.07
951, 30980, 1011, 1, 0, 0, 952030, 1001.08
952, 30725, 1001, 0, 0, 0, 953031, 1001.08
953, 30725, 1011, 3, 0, 0, 954042, 1001.09
954, 30980, 1001, 0, 0, 0, 955043, 1001.09
955, 28938, 991, 1, 0, 0, 956034, 1001.08
956, 28938, 1011, 0, 0, 0, 957045, 1001.09
957, 28938, 991, 2, 0, 0, 958036, 1001.08
958, 28938, 1001, 1, 0, 0, 959037, 1001.08
959, 28938, 1011, 0, 0, 0, 960048, 1001.09
960, 28938, 1001, 1, 0, 0, 961049, 1001.09
961, 28938, 1011, 2, 0, 0, 962060, 1001.1
962, 28938, 1001, 1, 0, 0, 963061, 1001.1
963, 28938, 1011, 0, 0, 0, 964072, 1001.11
964, 28938, 1001, 0, 0, 0, 965073, 1001.11
965, 28938, 991, 0, 0, 0, 966064, 1001.1
966, 28938, 991, 3, 0, 0, 967055, 1001.09
967, 28954, 1011, 2, 0, 0, 968066, 1001.1
968, 28954, 1001, 3, 0, 0, 969067, 1001.1
969, 28954, 1011, 0, 0, 0, 970078, 1001.11
970, 29002, 951, 0, 0, 0, 971029, 1001.06
971, 30472, 991, 2, 0, 0, 972020, 1001.05
972, 29962, 1001, 0, 0, 0, 973021, 1001.05
973, 30472, 1001, 2, 0, 0, 974022, 1001.05
974, 29962, 1001, 1, 0, 0, 975023, 1001.05
975, 29962, 1011, 2, 0, 0, 976034, 1001.06
976, 30472, 991, 2, 0, 0, 977025, 1001.05
977, 29962, 991, 2, 0, 0, 978016, 1001.04
978, 32002, 991, 2, 0, 0, 979007, 1001.03
979, 29962, 991, 0, 0, 0, 979998, 1001.02
980, 32002, 1001, 2, 0, 0, 980999, 1001.02
981, 29962, 1001, 3, 0, 0, 982000, 1001.02
982, 29962, 1011, 2, 0, 0, 983011, 1001.03
983, 32512, 991, 3, 0, 0, 984002, 1001.02
984, 31237, 991, 3, 0, 0, 984993, 1001.01
985, 31237, 991, 0, 0, 0, 985984, 1001
986, 31237, 1011, 1, 0, 0, 986995, 1001.01
987, 31237, 1001, 2, 0, 0, 987996, 1001.01
988, 31237, 1011, 3, 0, 0, 989007, 1001.02
989, 31237, 1001, 0, 0, 0, 990008, 1001.02
990, 31237, 1011, 0, 0, 0, 991019, 1001.03
991, 31237, 1011, 0, 0, 0, 992030, 1001.04
992, 31237, 1011, 1, 0, 0, 993041, 1001.05
993, 31237, 1001, 3, 0, 0, 994042, 1001.05
994, 31237, 1001, 0, 0, 0, 995043, 1001.05
995, 31237, 1011, 1, 0, 0, 996054, 1001.06
996, 31237, 1001, 1, 0, 0, 997055, 1001.06
997, 32512, 1001, 3, 0, 0, 998056, 1001.06
998, 31237, 1001, 3, 0, 0, 999057, 1001.06
999, 31237, 1001, 1, 0, 0, 1.00006e+06, 1001.06
1000, 31237, 1001, 3, 0, 0, 1.00106e+06, 1001.06
1001, 31269, 1001, 0, 0, 0, 1.00206e+06, 1001.06
